1111111111111111111111111111111111111111111111111111111111111111111111111111111111111111111111111111
1100000011101010001000010001010110010011011000010000101010100110010001011010100001000001010011100011
1100000001000000010110000000010000000010010000001000000100001010001000010010001010101010111100100011
1010010000000110010010000011010001001000110010010100000001101111100001001010100000101010000000000001
1011000001000000101010100000011001000000000010001010010100001010000110110010001000010001010001010001
1011100100010000001000000101000001000110110001000000000000100011000010010010000001000010010101000011
1000011011000101000001010010111000100010000010001010000000000011100110101011100100000010000100001011
1000110000000010110000100111101001100001100001010000010000000000000010000000000000101010100000101111
1001111101000101001111001100101100000001100111111100011100000010010010110100000011111010000001111001
1000100000000001110100111000001100001000010011011010110001111011010001101011001000001000000001001101
1100101110110011110000001010010000000000001001100000001011000001010000100000010110100111010011101001
1100001010110100000000110101000001100110010110101001101100000010001101010100000100110000101000011001
1111000100000000101000010001100001100100000000011000101000000100111011001000001000001000010100000111
1101101000000100001100011111110010000010011100010001000100111001000101001100100000001001111100010001
1000101000011011010011000000011100000101010110100111000010000000100110000000000000011101000101000001
1010101000110100101000010010101011011100001100101000100111101001110101110100001101101000001010000001
1000011111111001110000000101000101111000001010100000010000111000000110000100000110100010101010100101
1100110000011001100011010011011011100110100111000001000000010010110001000111000100100110010010000101
1100100101110000100010010001100011010111010100010000010010111011001100011110000000000010101111010101
1000100000111000000110010001001100000000101111000100011000010101000001100100001111101100110001010001
1000100110101101100000010001110010110011010010100000000100110100001000000111000010101101001001001011
1100000000100010100100001110100111100100101110101000001010110000001010000000100010000010001000010011
1000000000000010010100010111010110000101010100100100001001001000000000000010101000101100001111000001
1001100001110000010100100100000000110100011000000010110110001010011001010000100010000101100100100101
1000001011101111010000000000100001000100000001100001010000001110010110001000100000110001010000011111
1100110010000100100011000101100000101101101001011000001110010101000001011001010101010000111001100111
1100100011100001110010000000000101011101000101000010011001101111011001001100000000000010100100110001
1101000100000010010010111000011000000000000011101010000000111000010011100001100001000000000000000011
1000000101010110010101111000100000010100100100000010011100101010100100001100100110110101000001010011
1010000010110100010010111010100001010001001000010000000000010001000001100001001100000000110000101011
1111011010000010101010010000100110010000000010100110000000100110100000000000000001000010100000000001
1010101010000001000011100100110001000000001101011111110100000110010000000100111101000011000011101001
1100001100110000110111000111100001010100011010010000101101101010010000011100010111100100001000000111
1100100100000011110100100011100111100110000011101001000110000111100100110000011011101000001000010101
1000001001001011111101000010000010010101100110001011000001000011011110001000101001101000000010001101
1010010100110000000100001001001011000010000010000101011000011100000100010011111011011000000100010101
1110010101100101000110010110001101000001000100111100000001010000110000000000010111011000000000100101
1000000010000011001100100010010001000100000010101001011100100010000100001100100110010011010010111111
1000000100100010000000100000001101110001100111000100100100111100100100100001001110000101001000010011
1110110111111100000000011110010010001111000100000000110000010010011001000000000110111000000001000001
1010010001010010000010010101001000100000000100011000010100001001001100011111010111000001111010000001
1100000010000011000011000000110001111100101010110100000011000000000100000100111000010100001010101001
1100000010000101010100011001010010100101100001101000100110000100000000001001000011110000100011000001
1010000001100000100010000000001010011111100010000000000000101000001001010001010001111001001010100001
1000001000100010010000000110010011000000000000011110110010100000000110001000001010000001000010011001
1001001000011001100000000010000100010100000110100110101001011000100100010010001000000001001000111001
1100111001010000000000000000010000101001010000000000000000000000011001100101000000100011100001001001
1011001000000000001000100010N01001100010010000000000000000010011110011010110000000011000001100100001
1000100110100001011011101100001000000111100000101000001001100000010100100000110001111001001101001001
1001010000010100100010000001100101101001000100001010001101000001100001000010000000010011000100000101
1001010000010100101000010001001101001111000100000100010110100001010110000110001000101001000000000001
1110000100100100000001001011000010011100100010010100000000001000110101101101100010000000100001100001
1011001011001110010011101000010111010000000100100000100100010000110000000110010101000000010010111001
1000000100010010000001000001100000100000111010001001000000000000001101000010000011000000000001100001
1000010101101000010010000110011000110010100110101001101000010010000010110000100101011000001101110101
1000010010000100010010100000100101010000001011100000101000110101100000001000101000000010000001011011
1110000101110000000000000010101100101011011010000001011101000000100000000100010011001001100110001101
1001011101010000100010100010100000000101110001000000000000100110001101001001111000100101000100010001
1000110101100000101010100101100011011000000110100110010100100000011000000001000010010001001100001001
1110010010001010000010000101000101111011000001011100101010011001101101010000110101000010111010010011
1010000010111001010011000010000101100100110111100110001100100010000101000000010101111110000000001001
1110001010110001011100010010000000000000101000000000101001110011001100100100111101011110111110101011
1101000100110101001010100100010001000011010101101100001011000100011001110110000001001000111000001101
1101011000010011001011001111000010000100100001100010000100010010011010010110000010000110101001011011
1110010010000000000011000100001011001110000011000001010001000010000101000000010000001100100000000001
1000001001000110110011001001000010010010100000001000001010010110001101000000001010000010011010101001
1001000000001000010110101000000000001010000000000000000011001001100111100000000011001101100000000001
1101001011110100101110010001100110010000001100000000100010001100010100000100100010000001000000010001
1100110101000000001110001010100000010001000010000010100000111010000000100101000011011101001000000111
1010110000001001010010000010100000000010000010000101011010100100101011000100011000010001110010001011
1100001100001101000000001010001000000001010100101001000011010010001100010100100010000000000010100001
1101000100000110111101010000000101000000000110110010000010001000000100000000100010000100011111011011
1001100010000001000001001001100100011000000000100010001000000010000100001000000000110010100010000001
1000000001000001100111000000000011000010001001000001010011000110101100001001100001000110000001001111
1000010000100010000001000101100100100001000100010001000000101011010011000000000100011110010011101001
1010110000000101110011001001011000000011110110001010001000100000000010100000001011000101001000100001
1110000001000010100100011000010010011010000100010100010111010001000000000100101000001100000000010011
1111011100001010010100110110001100110010101010000010101000110010100010000011010000010101000100000101
1100011101101110000011000101001001000101000001011011001100000010100100010101000010000001000100001011
1000000001100110000010000110010001100100100100000110100000000100100110000000011001100001000001011011
1000100001010010100010001110110100100000010110010010000110011000010001000100111010000100100000100101
1001000000000101010001000110001000000110100101000101100000000001000011000101000001101100010000101111
1010000001100000000100110100011000000101000001100100000100100001000011011001000000100111000000000001
1000011000100111001001001000000111010000001001010010100111100000000010010000000000000011110110011101
1010001001011000110110011000001011011110001000000100000010001000001001100011100111000100001000010001
1011110011110111101000000001001010010000001110100001010101010010101000010101000101011000111001000001
1000000001110110000111010010010000010000000010110001101000001110011000001101000000100000101101010001
1001100010000000001110010101000100010100000110001001000001000000000000101100001010000000001000011001
1001101110111101100100100000010010100000110010000001101100010011101011011011110010001000011001100101
1001000001000000100011100010000011000010010110000001000000110100010000000000110001001010111011001001
1100100110100011010111111000000111010010000010011010100100001000100100010101111010011001101100010011
1000000001010100010000001100110000101011010011110001100000100010000110110000010100011000101010011111
1001000010001010011001101010000010100001011001001001001000001001101000100011000000110111001110010001
1000100010010000000100011010000100010010100000010001011000000001100000101000000011000110001001000011
1000000110001101000011010000110010100011010111110011110001000000010001000000011001001010011100001011
1100010001010000001000100000010000000011101110000000010011000000000010001100000010100010100000100011
1111000111001111001000001011111011000100000100000001110000011111000001110100001001000000000000010101
1000001101000001000000000001000001000000001010000100110000000010000101000111000000100001011001001101
1011001001000100100011010001100010001100110101001001010100001000000011000001000000100000001000000001
1111111111111111111111111111111111111111111111111111111111111111111111111111111111111111111111111111
