11111111111111111111111111111111111111111111111111
10001000011001000100000010110111010010000110101011
10000000010000110110110010000111100010010110100001
11101000101011001111011110100010001001111100000001
11000010011010001000100001010011101011100001000001
10010000010010111100000101111111101001101000000011
10000110000010010000000010010000010001011001100001
11011000000101100011001001100100010000000001110011
10100101101001111001000000000001000001010000000101
1101110000000000011100S011100011100000000001000011
10001110101110010001000000000100000100000010001001
11101010001001000100100000000000101000000000001001
11010011000000110000100000001011010000010101111001
10110000010000000110000011111001100010001010001001
11101101100010000100110100100101000001001101000001
11000010100001010100000001100000101001000100000001
10110000101100110111000010000000001100000000110001
10010000100111010010000000001010110100110100000001
10110001000000001011100101010001110010111000000101
10001100101010100101111111110101000010001000100101
10110100100110001011100011101101101111000110100101
10001100000001101010000000000100011100111011111001
10101010110010000001000000101000010001001101010011
10111000011000010000001000001000110110100000000011
10100110001000100001001011010000100010000000000001
10000001000000101000110001001000010000010001001111
11010100001011000010011000010000110000110010000101
11101000101000001010000000010101100001001000101101
10100010100000100011000011000010110101000000101011
11010100111100011010001100010111111100000000011001
10110010110111000001100101111001111100010001010001
10000000000010000000010011001100001000100001000101
10000110101100001000001000000000100100010000001101
10000000101010100000000101001001000101010001010011
10001010000010000010100000000000101001000010100111
10010100011011011000110000011110000011000001111111
11110011000010000111100010010000000100011001000001
10010010010101010001101010000100000001101101011011
11010111101010010000000000011110110100000001001001
11110111100000010000010010000001100010110000111011
10001101011100100001000101011000010000000001110101
10001000010000101011110100101001100111010000001001
11110101000110010101010001001001101000101000010001
10000111110001000000001011000010000011001101010011
10001001100111001110000101001000111110001001010001
10110011001001111000101010010101000110001100110101
11000010011010011000111011111000100011001001000001
11101000000010000011001000110100101000100001000001
10001110100000101100001000000011000000110110100001
11111111111111111111111111111111111111111111111111
