11111111111111111111111111111111111111111111111111
10000100001011100101011100101011101110000010110001
11010111000101101011000000001010011010000000010001
100010001110001000001001001010S0110000000001100001
11000000101000000110001000001000001001000000100101
10000111010010000100111001100010111010000000000101
10001100001000100000010011000001000000001010110001
11001001100010001111000010101010010111010000010101
10100010000000011101011100000000000010000000111001
11011000111011110100001100110000000000000010000101
10000000010000101001010100110110011111000001100101
11011101101001110000100001000010000100101010001001
11000000000010111110001010011010000000010101111011
10111000010000100000110101010000010001101010000011
10000100110010000000001001100010010111000010000001
11110100010100001000000010010100110010000000000101
10011001110000011100100000001100011110011010100111
11010000010010110100100000001001000001101000110101
10001010010001000101101101000001100111100100011111
10011000100010000001111000001010101000101010101101
11000011001011000000001000010001101001100100001001
10000010011100010000000000010010001000000000100001
11010010101000000010001001000001000010011010101001
10111100010000001100010101110010100010001000100011
11001011001010101111110100000010010101100010000001
10000100010000100000000001100000000000000100001001
10000011000100000000110111011000001110110101100101
10000001111110101000110000000010110010011001101011
10011000000110000100101100010000001100110000010001
10000110000100100001000001110001001111000000010101
10001010100000000100000010100100011010011011110001
10100001010010101101000110100110010000110100100001
10000000010000010001000000000010010100000001110101
11110010100000010000110000100001000101100000100111
11000010000011111100100100000110001110000001110011
10010100010100001001111111010100011110011000100001
10000111000111101100000010000010000000000001001101
10010000100000110100010100111101011011000110001001
11101100010000100100001000011000000000000000101011
10000001001100101100000010001000100001100100011001
11001011001000001001000010111010110000000011110001
10001000011011000010001010001010110010000001110001
10100000100000011011101110001110110100110001010001
10011000000000101100101101010100000000001000001001
11001000000000110011000100001000100110001010010001
11001100000000101010011011011100010001001010100001
10100001000110101001110001100110000100001001000001
11000000111011011010001100110010000100001010000111
11100100010010001110001101010100000100010001000001
11111111111111111111111111111111111111111111111111
