NO assets/wall_north.xpm
WE assets/wall_west.xpm
EA assets/wall_east.xpm
SO assets/aasli.xpm

F 220,100,25
C 225,30,0
        111111111111111111111111
        1000000000110000000000001
        101100000111000000000001
        1001000000D000000N000001
111111111011000001110000000000001
10000000001100000111D111111111111
11110111111111011100000010001
11110111111111D11101010010001
11000000110101011100000010001
10000000000000001100000000001
1000000000000001101010010001
110000011101010111110111100111
11110111 1110101 101111010001
11111111 1111111 111111111111

